0 0 0 0 0 0 6 0 9
1 0 0 0 0 4 0 0 0
0 0 5 3 0 6 8 2 1
0 0 4 6 7 0 0 5 0
0 0 7 0 0 0 9 0 0
0 0 0 5 4 0 0 0 0
3 7 0 4 0 5 2 0 6
0 0 0 0 0 0 5 1 0 
0 6 0 0 2 0 0 3 7