0 1 0 0 0 0 4 3 0
7 0 0 0 0 0 0 0 0
0 0 0 2 5 4 9 0 0
1 7 0 0 4 0 2 0 6
0 0 0 0 9 0 0 0 3
0 0 3 0 0 6 0 8 0
0 0 1 4 7 0 0 6 0
0 0 0 5 0 8 1 2 0
0 9 0 0 6 0 3 0 4