0 4 0 0 0 9 0 0 0
0 0 9 0 0 4 1 6 0
0 0 0 6 8 5 4 0 0
0 0 5 4 7 0 0 0 1
0 9 4 0 0 1 0 0 6
0 1 0 0 2 6 3 0 0
0 0 0 0 0 0 0 0 3
9 0 1 0 0 0 6 0 0
0 0 8 1 0 7 0 5 0