1 5 0 0 4 2 0 0 6 
2 7 4 5 6 0 0 1 0 
0 0 6 0 0 7 4 0 2
0 1 0 0 0 0 0 4 0 
0 0 0 0 5 0 0 0 0 
0 6 0 4 0 3 1 9 0 
0 2 0 6 0 5 9 0 0 
9 8 5 0 3 0 0 6 0 
0 4 0 2 1 9 8 3 0